    00000000000000000000000000000000000000000000000000000000000000000000000000000000000000000000000000001111111111111111111111111111
    00000000001111111111222222222233333333334444444444555555555566666666667777777777888888888899999999990000000000000000000022222222
    01234567890123456789012345678901234567890123456789012345678901234567890123456789012345678901234567890123456789012345678901234567   
   
    00000000000000000000000000000000222222222222222233333333333333334444444444444444555555555555555566666666666666667777777777777777
    0123456789ABCDEF0123456789ABCDEF0123456789ABCDEF0123456789ABCDEF0123456789ABCDEF0123456789ABCDEF0123456789ABCDEF0123456789ABCDEF
-----------------------------------------------------------------------------------------------------------------------------------
000|22222222222222222222222222222222222222222222222222222222222222222222222222222222222222222222222222222222222222222222222222222222
001|22222222222222222222222222222222222222222222222222222222222222222222222222222222222222222222222222222222222222222222222222222222
002|22222222222222222222222222222222222222222222222222222222222222222222222222222222222222222222222222222222222222222222222222222222
003|22222222222222222222222222222222222222222222222222222222222222222222222222222222222222222222222222222222222222222222222222222222
004|22000000000000000000000000000000000000000000000000000000000000000000000000000000000000000000000000000000000000000000000000000022
005|22000000000000000000000000000000000000000000000000000000000000000000000000020000000000000000000000000000000000000000000000000022
006|22000000000000000022222000000000000000200002000000000000000000000000000000020022200000000000000000000002000000000000000000000022
007|22000000000000000020000000000000000000200020000000000000000000000000000000200020020000000000000000000002000000000000000000000022
008|22000000000000000020000000002000000000200200000000000000000000000000000000200020002000000000000000000002000000000000000000000022
009|22000000000000000020000000000000000000202000000000000000000000000000000002000020002000000000000000000002000000000000000000000022
00A|22000000000000000022200020202002220000220000020200222020002002220022000002000020002020002002220002220002000000220000000000000022
00B|22000000000000000020000022002020000000202000022002002020002020000200200020000020002020002020002020020002000002002000000000000022
00C|22000000000000000020000020002020000000200200020002002020002002200222200020000020002020002020002020020002000002222000000000000022
00D|22000000000000000020000020002020000000200020020002002020002000020200000200000020020020002020002020020002000002000000000000000022
00E|22000000000000000022222020002002220000200002020000222002220022200022200200000022200002220020002002220002222200222000000000000022
00F|22000000000000000000000000000000000000000000000000000000000000000000002000000000000000000000000000020000000000000000000000000022
010|22000333333333333333333333333333333333333333333333333333333333333333332333333333333333333333333333323333333333333333333333300022
011|22000000000000000000000000000000000000000000000000000000000000000000000000000000000000000000000000020000000000000000000000000022
012|22000000000000000000000000000000000003300000000000000000000000000000000000000000000000000000000022200000000000000000000000000022
013|22000000000000000000000000000000000003300000000000000000000000000000000000000000000000000000000000000000000000000000000000000022
014|22000000330000000000000000000000000000000000000000000000000000000003300000000000000000000000000000000000000000033000000000000022
015|22000000330000000000000000000000000000000000000000000000000000000033330000000000000000000000000000000000000000033000000000000022
016|22000000330000000000000000000000000000000000000000000000000000000003300000000000000000000000000000000000000000033000000000000022
017|22000333003330000000000000000000000000000000000000000000000000000000000000000000000000000000000000000000000000033000000000000022
018|22000333003330000000000001111111111111111111111111111111111111111111111111111111111111111111100000000000000000033000000000000022
019|22000000330000000000000001333333333333333333333333333333333333333333333333333333333333333333100000000000003333300333330000000022
01A|22000000330000000000000001333333333333333333333333333333333333333333333333333333333333333333100000000000003333300333330000000022
01B|22000000330000000000000001333333333333333333333333333333333333333333333333333333333333333333100000000000000000033000000000000022
01C|22000000000000000000011111000000000000000000000000000000000000000000000000000000000000000000111110000000000000033000000000000022
01D|22000000000000000000013330000000000000000000000000000000000000000000000000000000000000000000033310000000000000033000000000000022
01E|22000000000000000000013330000000000000000000000000000000000000000000000000000000000000000000033310000000000000033000000000000022
00F|22000000000000000000013330000000000000000000000022220000000000000000000000000000000000000000033310000000000000033000000000000022
020|22000000000000000111110000000000022220000000000022220000000000000000000000000000000000000000000011111000000000000000000000000022
021|22000000033000000133300000000000022220000000000022220000000000000000000000000000000000000000000003331000000000000000000000000022
022|22000000033000000133300000000000022220000000000022220000000000000000000000000002222000000000000003331000000000000000000000000022
023|22000000000000000133300000000000022220000000000000000000000000000000000000000002222000000000000003331000000000000000000000000022
024|22000000000000000133300000000000000000000000000000000000000000000000000000000002222000000000000003331000000000000000000000000022
025|22000000000000000133300000000000000000000000000000000000000000002222000000000002222000000000000003331000000000000000000000000022
026|22000000000000000133300000000000000000000000000000000000000000002222000000000000000000000000000003331000000000000000000000000022
027|22000000000000000133300000000000000000000000000000000000000000002222000000000000000000000000000003331000000000000000000000000022
028|22000000000000000133300000000000000000000222200000000000000000002222000000000000000000000000000003331000000000000000000000000022
029|22000000000000000133300000000000000000000222200000000000000000000000000000000000000000000000000003331000000000000000000000000022
02A|22000000000000000133300000000000000000000222200000000000000000000000000000000000000000000000000003331000000000000000000000000022
02B|22000000000000000133300000000000000000000222200000000000000000000000000000000000000000000000000003331000000000000000000000000022
02C|22000000000000000133300000000000000000000000000000000000000000000000011111133000022220000000000003331000000003331111100000000022
02D|22022222222200000133300000000000000000000000000000000000000000000000013333133000022220000000000003331000000003313333100000000022
02E|22022222222222220133300000000000000000000000000000000000000000000000013333313000022220000000000003331000000003133333100000000022
02F|22022222222222220133300000000000000000000000000000000000000000000000013333331000022220000000000003331000000001333333100000000022
030|22022222222222220133300000000000000000000000000000000000000000000111133333333133300000000000000003331000033313333333111110000022
031|22022222222222220133300000000000000000000000000000000000000000000133333333333313300000000000000003331000033133333333333310000022
032|22022222222222220133300000000222200000000000000000002222000000000133333333333331300000000000000003331000031333333333333310000022
033|22000000000022220133300000000222200000000000000000002222000000000133333333333333100000000000000003331000013333333333333310000022
034|22022222222200000133300000000222200000000000000000002222000000000133333333333333313330000000000001111333133333333333333310000022
035|22022222222222220133300000000222200000000000000000002222000000000133333333333333331330000000000001333331333333333333333310000022
036|22022222222222220133300000000000000000000000000000000000000000000133333333333333333130000000000001333313333333333333333310000022
037|22022222222222220133300000000000000000000000000000000000000000000133333333333333333310000000000001333133333333333333333310000022
038|22022222222222220133300000000000000000000000000000000000000000000133333333333333333331111111111331111333333333333333333310000022
039|22022222222222220133300000000000000000000000000000000000000000000133333333333333333333333333333333333333333333333333333310000022
03A|22000000000022220133300000000000000000000000000000000000000000000133333333333333333333333333333333333333333333333333333310000022
03B|22022222222200000133300000000000000000000000000000000000000000000133333333333333333333333333333333333333333333333333333310000022
03C|22022222222222220133300000000000000000000000000000000000000000000133333333333333333333333333333333333333333333333333333310000022
03D|22022222222222220133300000000000000000000000000000000000000000000133333333333333333333333333333333333333333333333333333310000022
03E|22022222222222220133300000000000000000000000002222000000000000000133333333333333333333333333333333333333333333333333333310000022
03F|22022222222000000133300000000000000000000000002222000000000000000333333333333333333333333333333333333333333333333333333310000022
040|22022222222001113133300000000000000000000000002222000000000001111333333333333333333333333333333333333333333333333333333311111022
041|22022222222001333133300000000000000000000000002222000000000001333333333333333333333333333333333333333333333333333333333333331022
042|22022222222001333133300000000000000000000000000000000000000001333333333333333333333333333333333333333333333333333333333333331022
043|22000000000001333133300000000000000000000000000000000000000001333333333333333333333333333333333333333333333333333333333333331022
044|22111111111111333133300000000000000000000000000000000000000001333333333333333111111113333333333333333333311111111333333333331022
045|22333333333333333133300000000000000000000000000000000000000001333333333333333100011113333333333333333333310001111333333333331022
046|22333333333333333133300000000000000000000000000000000000000001333333333333333100011113333333333333333333310001111333333333331022
047|22333333333333333133300000000000000000000000000000000000000001333333333333333100011113333333333333333333310001111333333333331022
048|22333333333333333133300000022220000000000000000000000000000001333333333333333111111113333333333331111333311111111333333333331022
049|22333333333333333133300000022220000000000000000000000000000001333333333333333111111113333333333331111333311111111333333333331022
04A|22333333333333333133300000022220000000000000000000000000000001333333333333333111111113333333333331111333311111111333333333331022
04B|22333333333333333133300000022220000000000000000000000000000001333333333333333111111113333333333331111333311111111333333333331022
04C|22333333333333333133300000000000000000000000000000000000000001333333322222222333333333333333333333333333333333333222222223331022
04D|22333333333333333133300000000000000000000000000000000000000001333333322222222333333333333333333333333333333333333222222223331022
04E|22333333111111113133300000000000000000000000000000000000000001333333322222222333333333333333333333333333333333333222222223331022
04F|22333333100000000133300000000000000000000000000000000000000001333333322222222333333333333333333333333333333333333222222223331022
051|22333333100222220133300000000000000000000222200000000000000001333333322222222333311113333333311113333333311113333222222223331022
050|22333333100222220133300000000000000000000222200000000000000001333333322222222333311113333333311113333333311113333222223333331022
052|22111111100222220133300000000000000000000222200000000000000001333333322222222333311113333333311113333333311113333222223333331022
053|22000000000222220133300000000000000000000222200000000000000001111333322222222333311113333333311113333333311113333222223311111022
054|22222222222222220133300000000000000000000000000000000000000000001333333333333333311111111111111111111111111113333333333310000022
055|22222222222222220133300000000000000000000000000000000000000000001333333333333333311111111111111111111111111113333333333310000022
056|22222222222222220133300000000000222200000000000000000000000000001333333333333333311111111111111111111111111113333333333310000022
057|22000000000222200133300000000000222200000000000000000000000000001111133333333333311111111111111111111111111113333333311110000022
058|22000000000000000133333330000000222200000000000000000000000000000000013333333333333333333333333333333333333333333333100000000022
059|22000000000000000133333330000000222200000000000000000000000000000000013333333333333333333333333333333333333333333331300000000022
05A|22000000000000000133333330000000000000000000000000000000000000000000013333333333333333333333333333333333333333333313300000000022
05B|22000000000000000133333330000000000000000000000000000000000000000000013333333333333333333333333333333333333333333133300000000022
05C|22000000000000000133333333333333333333333333333333333333333333333333331333333333333333333333333333333333333333331000000000000022
05D|22000000000000000133333333333333333333333333333333333333333333333333333133333333333333333333333333333333333333331000000000000022
05E|22000000000000000133333333333333333333333333333333333333333333333333333313333333333333333333333333333333333333331000000000000022
05F|22000000000000000111111111111333111111331111111111331111111111111111123331111133111111111133111111331111111111331000000000000022
060|22000000000000000133333333333333100001333333333333331000000000000000000000000133333333333333100001333333333333331000000000000022
061|22000000000000000133333333333333100001333333333333331000000000000000000000000133333333333333100001333333333333331000000000000022
062|22000000000000000133333333333333100001333333333333331000000000000000000000000133333333333333100001333333333333331000000000000022
063|22000000000000000133333333331111100001111133333333331000000000000000000000000111113333333333100001111133333333331000000000000022
064|22000000000000000133333333331000000000000133333333331000000000000000000000000000013333333333100000000133333333331000000000000022
065|22000000000000000133333333331000000000000133333333331000000000000000000000000000013333333333100000000133333333331000000000000022
066|22000000000000000133333333331000000000000133333333331000000000000000000000000000013333333333100000000133333333331000000000000022
067|22000000000000000111111111111000000000000111111111111000000000000000000000000000011111111111100000000111111111111000000000000022
068|22000000000000000000000000000000000000000000000000000000000000000000000000000000000000000000000000000000000000000000000000000022
069|22000000000000000000000000000000000000000000000000000000000000000000000000000000000000000000000000000000000000000000000000000022
06A|22000000000000000000000000000000000000000000000000000000000000000000000000000000000000000000000000000000000000000000000000000022
06B|22000000000000330000000000000000000000000000000000000000000000033000000000000000000000000000000000000000003300000000000000000022
06C|22000000000000330000000000000000000000000000000000000000000003300330000000000000000000000000000000000000003300000000000000000022
06D|22000000000000330000000000000000000000000000000000000000000000033000000000000000000000000000000000000000003300000000000000000022
06E|22000000000333003330000000000000000000000330000000000000000000000000000000000000000000000000000000000003330033300000000000000022
06F|22000000000333003330000000000000000000000330000000000000000000000000000000000000000000000000000000000003330033300000000000000022
070|22000000000000330000000000000000000000000000000000000000000000000000000000000000000000000000000000000000003300000000000000000022
071|22000000000000330000000000000000000000000000000000000000000000000000000000000000000000000000000000000000003300000000000000000022
072|22000000000000330000000000000000000000000000000000000000000000000000000000000000000000330000000000000000003300000000000000000022
073|22000000000000000000000000000000000000000000000000000000000000000000000000000000000000330000000000000000000000000000000000000022
074|22000000000000000000000000000000000000000000000000000000000000000000000000000000000000000000000000000000000000000000000000000022
075|22000000000000000000000000000000000000000000000000000000000000000000000000000000000000000000000000000000000000000000000000000022
076|22222222222222222222222222222222222222222222222222222222222222222222222222222222222222222222222222222222222222222222222222222222
077|22222222222222222222222222222222222222222222222222222222222222222222222222222222222222222222222222222222222222222222222222222222
078|22222222222222222222222222222222222222222222222222222222222222222222222222222222222222222222222222222222222222222222222222222222
079|22222222222222222222222222222222222222222222222222222222222222222222222222222222222222222222222222222222222222222222222222222222
07A|22222222222222222222222222222222222222222222222222222222222222222222222222222222222222222222222222222222222222222222222222222222
07B|22222222222222222222222222222222222222222222222222222222222222222222222222222222222222222222222222222222222222222222222222222222
07C|22222222222222222222222222222222222222222222222222222222222222222222222222222222222222222222222222222222222222222222222222222222
07D|22222222222222222222222222222222222222222222222222222222222222222222222222222222222222222222222222222222222222222222222222222222
07E|22222222222222222222222222222222222222222222222222222222222222222222222222222222222222222222222222222222222222222222222222222222
07F|22222222222222222222222222222222222222222222222222222222222222222222222222222222222222222222222222222222222222222222222222222222
